Context:
"Predict behavior to retain customers. Analyze all relevant features from customer data to develop a prediction model."

Content:
Each row represents a customer data and each column contains a feature.

The data set includes information about:
Customers who left within the last month – the column is called Churn
Services that each customer has signed up for – phone, multiple lines, internet, online security, online backup, device protection, tech support, and streaming TV and movies
Customer account information – how long they’ve been a customer, contract, payment method, paperless billing, monthly charges, and total charges
Demographic info about customers – gender, age range, and if they have partners and dependents

About Features:
customerID: Customer ID
gender: Whether the customer is a male or a female
Senior Citizen: Whether the customer is a senior citizen or not (1, 0)
Partner: Whether the customer has a partner or not (Yes, No)
Dependents: Whether the customer has dependents or not (Yes, No)
tenure: Number of months the customer has stayed with the company
Phone Service: Whether the customer has a phone service or not (Yes, No)
Multiple Lines: Whether the customer has multiple lines or not (Yes, No, No phone service)
Internet Service: Customer’s internet service provider (DSL, Fiber optic, No)
Online Security: Whether the customer has online security or not (Yes, No, No internet service)
Online Backup: Whether the customer has online backup or not (Yes, No, No internet service)
Device Protection: Whether the customer has device protection or not (Yes, No, No internet service)
Tech Support: Whether the customer has tech support or not (Yes, No, No internet service)
StreamingTV: Whether the customer has streaming TV or not (Yes, No, No internet service)
Streaming: Whether the customer has streaming movies or not (Yes, No, No internet service)
Contract: The contract term of the customer (Month-to-month, One year, Two year)
Paperless Billing: Whether the customer has paperless billing or not (Yes, No)
Payment Method: The customer’s payment method (Electronic check, Mailed check, Bank transfer (automatic), Credit card (automatic))
Monthly Charges: The amount charged to the customer monthly
Total Charges: The total amount charged to the customer
Churn Label: Whether the customer churned or not (Yes or No)